00000000000000000000
00000000000000000000
00000000000000000000
00000000000000000000
00000000000000000000
00000000000000000000
22222222222222222222
33113311331133113311
11111111111111111111
33333333333333333333
11111111111111111111
33333333333333333333
00000000000000000000
